



            @@@@@@@                           
        @@@@       @@@@@@                         
       @                 @@                             
      @@                  @                         <(* )    
       @@        @@@     @                            (  == )    
         @@@@@@@@   @@@@@                               ^ ^
                                                     
                               
                                
                                      
                                        
                                     
                                                   












                                                 ###### 
                                         ######    ##
                                           ##     #### 
                                           ##      ##
                                           ##      ##
**********************************************************************
**********************************************************************
                                                                      