   



            @@@@@@@                           
        @@@@       @@@@@@                         
       @                 @@                             
      @@                  @                                 
       @@        @@@     @                                 
         @@@@@@@@   @@@@@                             
                                                   
















                                          ############
                                               ##
                                               ##
                                            ########  
              ########                         ##
                 ##                            ##
                 ##                            ##
**********************************************************************
**********************************************************************
                                                                      