   



                                  @@@@@@@@@@@
                                 @            @@@@@@
                               @@                    @@@
                              @@                        @
                               @@@                     @@
                                 @@@@@         @@@ @@
                                       @@@@@@@@
















                                                    
                                                    
                            ######                              
                              ##     ######
                             ####      ##       
                              ##       ##
                              ##       ##
**********************************************************************
**********************************************************************
                                                                      