   



                             @@@@@@@                           
                         @@@@       @@@@@@                            
                        @                 @@
                       @@                  @
                        @@        @@@     @                  
                          @@@@@@@@   @@@@@                          
                                                   


















                                                  ######  
                                                    ##  
                                                   #### 
                                                    ##
                                                    ##
**********************************************************************
**********************************************************************
                                                                      