  



                                     @@@@@@@@@@@
                                   @           @@@@@@@
                                 @@                   @@@@
                              @@@                        @@
                               @@@                        @@
                                 @@@@@            @@@ @@@@
                                       @@@@@    @@
 
         
               <(* )
                 ( == )
                   ^ ^












                                   
                                   ######
                                     ##
                                    ####    
                                     ##
                                     ##
**********************************************************************
**********************************************************************
                                                                      